Jeane	Christner
Traci	Dealtry
Kendall	Coates
Terrie	Cattley
Branda	Northey
Fletcher	Finlay
Stefanie	Summy
Paden	Herrold
Julianna	Ledgerwood
Saxon	Saline
Curtis	Cable
Braeden	Basinger
Trista	Morgan
Phoenix	Zaun
Janey	Roberts
Bernardine	Reese
Julianne	Fair
Maitland	Swartzbaugh
Callista	Steiner
Camden	Mcelroy
Sal	Pyle
Draven	Tripp
Ava	Johns
Ogden	Teagarden
Dalton	Franks
Wilford	Cavalet
Christi	Rosenstiehl
Briony	Southern
Nikkole	Bousum
Lance	Costello
Agnes	Mench
Haley	Drennan
Sera	Roadman
Eldreda	Bonner
Douglas	Best
Katelyn	Black
Hervey	Jowers
Kendrick	Mcmullen
Justy	Gearhart
Cathy	Adcock
Mandi	Akers
Juliet	Mccune
Bidelia	Reed
Gina	Throckmorton
Nicky	Rifler
Janie	Garratt
Mattie	Burns
Lambert	Schreckengost
Kristine	Hall
Arlene	Evans
Darien	Woollard
Lavina	Tennant
Seneca	Cowher
Hatty	Mary
Holly	Hatcher
Arkell	Baughman
Alana	Zoucks
Nerissa	Whirlow
Shauna	Geyer
Huey	Reiss
Magnus	Weldy
Miracle	Kifer
Amaranta	Kanaga
Molly	Kistler
Harve	Kooser
Gertrude	Williams
Kelley	Zundel
Bailey	Blyant
Monte	Beck
Marge	Benford
Murray	Weinstein
Alys	Pennington
Beau	Millard
Kaylie	Wilkins
Rylan	Handyside
Tina	Monroe
Julian	Mitchell
Lilith	Ehret
Hyacintha	Barnes
Dwayne	Haverrman
Berenice	Mingle
Naomi	Orner
Sharona	Stocker
Cory	West
Acacia	Barrett
Serena	Todd
Jayla	Isemann
Cherish	Oppenheimer
Bryan	Stone
Gertie	Levett
Dick	Jenkins
Beckah	Soames
Olive	Law
Donna	Richards
Wiley	Clarke
Marci	Tomco
Davin	Endsley
Zak	Ritter
Nicholas	Marriman
Warren	Kimmons
Caitlyn	Hunt
Ronda	Moon
Tanika	Appleby
Allen	Earhart
Nirvana	Todd
Jessye	Werner
Saffron	Pycroft
Cammie	Parkinson
Kenelm	Bollinger
Lisa	Oneal
Jasmin	Keener
Deforest	Pratt
Bernard	Pullman
Jeb	Nicholas
Su	Catleay
Felicity	Archibald
Reene	Hayhurst
Lucian	Chapman
Gaynor	Fuchs
Shelby	Gibson
Jacinth	Elinor
Ursella	Knisely
Nan	Goldvogel
Rebecca	Hill
Trevelyan	Treeby
Joan	Warren
Beulah	Young
Ira	Easter
Kaety	Driggers
Susannah	Joghs
Tonia	Brindle
Rickey	Gardner
Zavier	Harper
Alexis	Pfeifer
Timmy	Anderson
Winston	Mang
Alexus	Bender
Earlene	Barr
Florinda	Swain
Ralphie	Mortland
Adelle	Crom
Myriam	Millhouse
Page	Brown
Elvis	Crissman
Staci	Fiscina
Raymond	Wise
Katlyn	Campbell
Reagan	Fields
Trix	Reed
Loyd	Kemble
Sapphire	Coveney
Saranna	Moffat
Kenith	Lane
Frances	Henry
Kizzy	Gongaware
Lorayne	Fitzgerald
Merla	Quinn
Marion	Baer
Jaden	Haile
Seraphina	Casteel
Blanch	Wible
Tess	Pittman
Gresham	Countryman
Darell	Wilkinson
Howie	Errett
Stacee	Ludwig
Danny	Overstreet
Tammi	Philips
Candida	Olphert
Elaine	Bishop
Catharine	Knight
Justice	Hooker
Cordell	Otis
Petrina	Zalack
Berry	Day
Shelley	Tomey
Carita	Hector
Travers	Reighner
Royce	Priebe
Camryn	Demuth
Fulk	Stafford
Lorena	Mosser
Phyllis	Fraser
Jimmy	Vorrasi
Clancy	Billimek
Isidora	Hiles
Rosie	Davis
Will	Erskine
Ambrose	Ramsey
Peregrine	Muller
Lashonda	Dryfus
Hollie	Kern
Billy	Williamson
Giselle	Beard
Nanette	Adams
Elouise	Greif
Jarred	Sanforth
Vince	Atweeke
Hale	Schuck
Ellis	Poorbaugh
Gorden	Mcintosh
Lane	Baird
Audie	Simpson
Alissa	Conkle
Janel	Dean
Anneka	Geddinge
Dalya	Young
Ern	Burney
Tommy	Chappel
Concordia	Sandys
Joanne	Cowper
Lucas	Sullivan
Perry	Martin
Jenessa	Bennett
Kameron	Alington
Megan	Ballou
Mable	Thorley
Reuben	Peters
Marcy	Whittier
Sonny	Blunt
Tori	Wheeler
Lemoine	Wain
Aida	Ray
Waldo	Sheets
Cordula	Painter
Kelly	Lalty
Kory	Ackerley
Kestrel	Hall
Reynold	Smail
Elicia	Baumgartner
Regan	Barnes
Zilla	Mcfall
Normand	Hills
Emmerson	Elsas
Lavern	Feufer
Rachael	Stall
Rudolph	Steele
Willard	Ulery
Dexter	Sybilla
Katherina	Adams
Aislin	Downing
Ginnie	Sachse
Nelda	Ewing
Kilie	Stanfield
Angelina	Willey
Chandler	Fowler
Eartha	Hozier
Marlyn	Mckinnon
Virgie	Jolce
Mya	Thomas
Florence	Mens
Kyla	Warner
Zacharias	Eisaman
Sonnie	Maclagan
Walton	Wolff
Pip	Warren
Merrilyn	Hicks
Roddy	Garland
Savannah	Harden
Elliot	Brinigh
Nolan	Robertson
Katee	Marjorie
Tyrrell	Welty
Rik	Dimsdale
Emory	Wylie
Ronnie	Beals
Claudia	Catlay
Lake	Bunten
Rexanne	Reade
Cassandra	Snyder
Jerrod	Hindman
Barry	Keilbach
Latasha	Crawford
Emmanuel	Swink
Vicky	Strickland
Regana	Bynum
Marlon	Newlove
Sandford	Kalp
Jaylee	Lowe
Olivia	Mason
Alison	Sutorius
Astra	Ratcliff
Shiloh	Lauffer
Geoff	Mackendrick
Sydney	Garneys
Tyler	Blessig
Georgie	Sanborn
Merletta	Albright
Pacey	Baker
Heath	Oppie
Vaughan	Mccallum
Prudence	Tedrow
Sharise	Gaskins
Emmeline	Cressman
Chrystal	Straub
Sharmaine	Baum
Katrina	Taggart
Jeremiah	Jardine
Breann	Kettlewell
Samantha	Sholl
Darcy	Poley
Eugene	Osterweis
Kimberlee	Fuller
Jackie	Beail
Raschelle	Lord
Gail	Bloise
Kendal	Keppel
Stanley	Berkheimer
Eliott	Brandenburg
Grant	Leach
Bailee	Hanford
Peg	Mitchell
Burton	Pheleps
Dean	Queer
Clemency	Christman
Jocelin	Grant
Tamera	Kline
Wisdom	Hallauer
Elsie	Trevithick
Laurine	Unk
Inigo	Burch
Andrew	Wardle
Zane	Faast
Corine	Wallick
Skye	Mills
Rosanna	Diller
Linsey	Stange
Daryl	Milliron
Gawain	Jackson
Major	Jackson
Clint	Dull
Quintin	Stoddard
Christian	Vanleer
Herman	Baker
Alfreda	Romanoff
Bettye	Powers
Ariadne	Watkins
Darla	Johnston
Braden	Monahan
Carina	Wallace
Merrick	Schuth
Lynwood	Taylor
Rick	Bickerson
Darcey	Fiddler
Alexandrea	Mull
Pattie	Wall
Oralie	Sanders
Peggie	Sommer
Dorinda	Emrick
Katie	Leslie
Desdemona	Graham
Ivory	Shea
Celestine	Osterwise
Leon	Bell
Ruthie	Johnson
Nina	White
Aloysius	Guest
Ryley	Mcloskey
Phoebe	Veith
Jepson	Ruhl
Laura	Elliott
Sherlock	Weingarten
Denzel	Coldsmith
Aric	Greenawalt
Roxy	Hoover
Carine	Haynes
Danette	Spring
Lucetta	Stroble
Duana	Whitehead
Jacinda	Jerome
Wren	Simmons
Rex	Caldwell
Sly	Harrold
Gwendoline	Rowley
Monty	Gibson
Dahlia	Munson
Bekki	Kimple
Barclay	Schere
Virginia	Moore
Kym	Kelley
Sky	Cram
Leann	Fox
Chrissy	Woodworth
Dan	Nicola
Larkin	Field
Joscelin	Gertraht
Bonnie	Hirleman
Jem	Hamilton
Zelda	Pershing
Sophy	Ullman
Shonda	Murray
Winthrop	Hujsak
Berniece	Hoopengarner
Kolour	James
Tacey	Mathews
Jaye	Munshower
Dulcie	White
Marsha	Pearson
Johnnie	Hil
Brandie	Cady
Barrett	Riggle
Ashlyn	Kepple
Jen	Bicknell
Clement	Stiffey
Jerald	Gregory
Gloria	Sayre
Jilly	Widaman
Headley	Ann
Veronica	Tillson
Annmarie	Briner
Rowena	Chase
Barnabas	Dimeling
Leroy	Ream
Nandy	Winton
Abby	Rumbaugh
Delia	Hatch
Lilia	Park
Mckayla	Eisenhart
Radcliff	Altmann
Alanis	Lowry
Camilla	Fry
Annie	Hildyard
Gwen	Lazzo
Palmer	Bullard
Meghan	Braham
Eleanor	Sell
Annice	Kadel
Laverne	Walker
Penny	Holts
Jerri	Vinsant
Isidore	Berry
Carrie	Klockman
Eula	Van
Kenny	Carpenter
Merle	Cypret
Wendy	Giesen
Idelle	Wood
Chantel	Osterweiss
Primula	Smothers
Aura	Flickinger
Colby	Stainforth
Audra	Children
Pru	Pratt
Gosse	Friedline
Robby	Maugham
Wilburn	Morland
Topaz	Hegarty
Ernesta	Newbern
Quianna	Llora
Ross	Knopsnider
Kaleigh	Osteen
Frankie	Woolery
Carlyle	Staymates
Roland	Schofield
Jasper	Rader
Lysette	Shallenberger
Kyle	Christopher
Colin	Tavoularis
Boniface	Omara
Faithe	Burris
Alanna	Agg
Tresha	Lester
Collyn	Pritchard
Hedley	Wade
Kailee	Ruch
Rebekah	Cason
Quanah	Surrency
Tristan	Flick
Pearl	Beach
Tricia	Richter
Reannon	Sandford
Carlisa	Porter
Wenda	Bastion
Pat	Flanders
Temple	Hay
Roderick	Dunkle
Hubert	Ling
Richardine	Swift
Humphry	Knapp
Zeph	Hardy
Lea	Craig
Cherice	Blair
Triston	Meyers
Indy	Philbrick
Carlisle	Rohtin
Tracy	Felbrigge
Sampson	Schaeffer
Ariella	Barkley
Bert	Baskett
Munro	Weldi
Clem	Whitten
Twyla	Mueller
Galen	Powell
Roseann	Stroh
Sylvia	Lafortune
Janene	Littlefield
Prosper	Branson
Kitty	Stewart
Blanche	Brooks
Nikolas	Williams
Wright	Eisenmann
Jessica	Bruxner
Xaviera	Shaffer
Gerrard	Kemerer
Sefton	Hook
Hamilton	Ashbaugh
Peggy	Henderson
Daisy	Sutton
Abilene	Paul
Bill	Read
America	Roberts
Rolland	Camp
Jancis	Zimmer
Raven	Green
Parris	Huston
Lexia	Clewett
Christmas	Bash
Barbra	Buehler
Chloe	Agnes
Heather	Fillmore
Dwight	Watson
Ulric	Boyd
Lourdes	Buck
Phil	Leonard
Devin	Jenner
Judy	Eliza
Wolf	Jelliman
Jennifer	Basmanoff
Luvenia	Hutton
Crofton	Eastwood
Hennie	Toulmin
Arline	Bailey
Avelina	Drabble
Dorthy	Howard
Bessie	Smith
Harriette	Elless
Darwin	Henley
Ace	Schmiel
Zubin	Baxter
Maxwell	Altman
Haven	Jones
Innocent	Bratton
Doran	Earl
Maxene	Patterson
Sybilla	Garry
Lottie	Goodman
Pansy	Nash
Gwendolen	Moberly
Nydia	Laborde
Emma	Nabholz
Allegra	Carden
Terri	Whitling
Joann	Toke
Eveleen	Wyatt
Mo	Wells
Carolyn	Magor
Frederica	Yeskey
Jo	Sealis
Brook	Cherry
Mayson	Filby
Camron	Bould
Elisabeth	Ewing
Cameron	Herndon
Darden	Waldron
Ettie	Hoffhants
Lewis	Sanner
Dorothea	Werry
Sunday	Armstrong
Cody	Mercer
Jayna	Guess
Baptist	Leech
Marlee	Newbiggin
Deana	Sadley
Emily	Richardson
Zachariah	Eva
Phyllida	Woodward
Keitha	Mckendrick
Beverly	Erschoff
Branden	Gettemy
Makenna	Rowe
Manfred	Harding
Hector	Willcox
Manuel	Joyce
Fleur	Candles
Lana	Harshman
Johnathon	Nehling
Roxane	Kava
Dennis	Ring
Sarah	Byers
Isador	Sulyard
Peyton	Perkins
Evangelina	Diegel
Laryn	Roche
Marshan	Enderly
Sharyl	Shick
Polly	Hoenshell
Keturah	Gilman
Roydon	Donkin
Charlotte	Edwards
Gordon	Ironmonger
Wilkie	Miller
Clara	Parrish
Hepsie	Randolph
Kimmy	Rodacker
Lucile	Blackburn
Franklin	Laurence
Babs	Fisher
Bridie	Murray
Lola	Atkinson
Blossom	Whishaw
Skylar	Fylbrigg
Deanna	Wilkerson
Cullen	Saltser
Tibby	Tue
Melitta	Wickes
Tameka	Isaman
Hyacinth	Wilks
Avalon	Polson
Anselm	Biery
Wesley	Roby
Jade	Stephenson
Tyrell	Napier
Liz	Buzzard
Pheobe	Eggbert
Anthony	Rummel
Emmie	Butterfill
Sebastian	Carmichael
Conor	Reamer
Mckenzie	Whiteman
Sloan	Ward
Estelle	Margaret
Edie	Prechtl
Morton	Orbell
Keren	David
Imogene	Kepplinger
Lizzie	Faqua
Elton	Groah
Goodwin	Garneis
Alisa	Gottwine
Alec	Shaner
Kelsie	Tireman
Marlowe	Potter
Wayland	Mildred
Glory	Griffis
Malinda	Burkett
Hilary	Cook
Tarina	Hatfield
Dane	Weisgarber
Aldous	Smith
Kassy	Knapenberger
Merideth	Nickolson
Clark	Anderson
Marvyn	Laurenzi
Kezia	Foster
Sterling	Bowchiew
Alicia	Batten
Ally	Busk
Ulysses	Mcmichaels
Louis	Churchill
Pene	Newton
Carmella	Prevatt
Lennard	Turzanski
Gilberta	Toyley
Tanya	Lacon
Grenville	Rhinehart
Deryck	Conrad
Joleen	Lotherington
Cristal	Holtzer
Rain	Fischer
Letty	Raub
Rubye	Davis
Lakeisha	Mays
Shari	Highlands
Dorcas	Hynes
Cheryl	Swarner
Adam	Gadow
Rachel	Duncan
Luanna	Schmidt
Colton	Wheeler
Weston	Bennett
Linda	Eckhardstein
Val	Hair
Garnet	Allshouse
Winfred	Fisher
Ciel	Barth
Kayleah	Wiggins
Salal	Schrader
Josslyn	Linton
Ella	Wortman
Spring	Ramos
Marylou	Houser
Antony	Hahn
Diamond	Lucy
Joselyn	Bard
Alan	Hardie
Haydee	Gleper
Hazel	Shupe
Raphael	Bryant
Justin	Beedell
Jane	Newman
Braidy	Giesler
Meriwether	Rahl
Syd	Patterson
Valarie	Bagley
Rosemary	Draudy
Maggie	Blatenberger
Leland	Wentzel
Rafe	Heyman
Jean	Stern
Judie	Marshall
Davina	Hawker
Bryony	Hobbs
Trinity	Gist
Alwilda	Losey
Jemima	Osteen
Brittany	Iseman
Clinton	Leichter
Melva	Blois
Allannah	Bryan
Honour	Kellogg
Gwendolyn	Chauvin
Digby	Higgens
Hughie	Thigpen
Comfort	Tomlinson
Keira	Cass
Rosalyn	Glover
Kat	Burnett
Pam	Cox
Dion	Rosensteel
Africa	Johann
Deanne	Alice
Travis	Fuhrer
Radclyffe	Kuster
Alethea	Armstrong
Missie	Metzer
Jerrard	Pickering
Hortensia	Cribbs
Xena	Shirey
Phillis	Merryman
August	Jewell
Janis	Eiford
Jeanie	Echard
Corrie	Robinson
Christy	Tanner
Ashley	Armitage
Stuart	Mcindoe
Kaitlyn	Graff
Miranda	Bauerle
Skyler	Ward
Sadie	Quirin
Isabelle	Swabey
Bertram	Weidemann
Tiger	Elizabeth
Marianna	Dugmore
Jocelyn	Breitenstein
Read	Cox
Ina	Mayers
Kyler	Pearsall
Garey	Cowart
Colene	Ropes
Scott	Wile
Fay	Hunter
Kerenza	Zadovsky
Creighton	Fea
Kent	Heckendora
China	Courtney
Joseph	Dennis
Stacie	Roose
Jaynie	Mcclymonds
Norton	Harris
Bernetta	Rega
Cambria	Hasely
Timothy	Milne
Rickie	Fonblanque
Benedicta	Hughes
Cybill	Agg
Tetty	Dale
Neville	Overholt
Sidony	Kiefer
Ghislaine	Bridger
Lyndsey	Pawle
Eve	Alliman
Royale	Style
Milo	Frankenberger
Peppi	Alcocke
Frank	Judge
Lori	Siegrist
Barnaby	Braun
Sierra	Rockwell
Pamelia	Thomlinson
Lotus	Seidner
Cadence	Elder
Honor	Holdsworth
Jaquelyn	Wolfe
Henry	Lineman
Marilena	Porter
Monday	Doverspike
Sukie	Trout
Mercia	Auman
Marlena	Drumm
Lalla	Carbaugh
Rickena	Mccullough
Nelly	Thompson
Melissa	Eve
Danielle	Logue
Isa	Wilson
Lilly	Little
Alannis	Jube
Raymund	Owen
Nowell	King
Lise	Coughenour
Camellia	Pinney
Conrad	Wells
Livia	Hincken
Jep	Lowstetter
Kate	Wynne
Jamie	Wynter
Briar	Ashmore
Sigmund	Harrow
Breanna	Larson
Merlin	Saylor
Suzie	Walker
Caleigh	Shaw
Laurelle	Hurst
Georgene	Schneider
Ritchie	Reichard
Columbine	Pirl
Roseanne	Greenwood
Vivian	Sandblom
Uland	Loewentsein
Susan	Houston
Tiffani	Yates
Melba	Baldwin
Godfrey	Birdsall
Krista	Langston
Kenneth	Wegley
Amie	Moore
Lanny	Bashline
Jaxon	Marcotte
Loraine	Aultman
Jacob	Keister
Garland	Townsend
Tiphanie	Rice
Malachi	Briggs
Abel	Reddish
Nikki	Lombardi
Osbert	Neely
Isadore	Fleming
Louisa	Gronko
Donny	Mccrady
Jeni	Stahl
Susanna	Haines
Lyndon	Buttermore
Sacheverell	Blaine
Gerard	Wildman
Bernice	Sloan
Willis	Gisiko
Lonny	Callison
Winnie	Putnam
Dawn	Weeter
Janna	Lear
Kade	Zeal
Graham	Catherina
Cal	Dugger
Rylee	Durstine
Poldie	Sidower
Tara	Hawkins
Ferne	Shafer
Brittani	Pierce
Francene	Shotts
Eunice	Huey
Lynette	Holdeman
Randa	Congdon
Selby	Cross
Sanford	Moulton
Trish	James
Korbin	Curry
Len	Bellinger
Shawn	Mixey
Alyson	Noton
Kellie	Jesse
Keziah	Sauter
Annis	Myers
Abner	Jyllian
Rena	Butt
Floyd	Ryals
Angelia	Butler
Luella	Compton
Myrtle	Scott
Dotty	Close
Jayme	Seelig
Duncan	Fulton
Horace	Fye
Joby	Koster
Carry	Warner
Roswell	Minnie
Wilton	Caesar
Sunshine	Rose
Lavone	Hatherly
Shana	Faust
Wyatt	Owens
Trixie	Eckert
Michaela	Yonkie
Cleo	Weeks
Arabella	Rogers
Destinee	Mcdonald
Nettie	Carr
Lonnie	Dickson
Miles	Sherlock
Keefe	Carter
Silvester	Mackendoerfer
Jocosa	Robinson
Lashawn	Patton
Sherrie	Foster
Perdita	Greene
Sawyer	Paynter
Ashlynn	Prescott
Maynard	Pery
Delmar	Mckee
Everitt	Koepple
Sherry	Fryer
Libby	Wood
Robert	Kight
Shell	Warrick
Eloise	Hastings
Benson	Finck
Crispian	Dunlap
Bentley	Hanseu
Clarinda	Bowman
Rube	Canham
Gay	Kunkle
Tamzen	Wilo
Scottie	Eisenman
Keysha	Howe
Tania	Lambert
Brianna	Bode
Aureole	Arthur
Wil	Aft
Della	Trovato
Flossie	Stough
Lisanne	Hays
Isolde	Wire
Elmer	Tilton
Sandy	Rhodes
Oswin	Mcdonald
Lois	Hice
Jenn	Moonshower
Cole	Rawls
Kendra	Boyer
Meriel	Focell	